axon.txt	coma.txt
allergy.txt	cholera.txt
aluminium.txt	beryllium.txt
anagrams.txt	anachronism.txt
anachronism.txt	anagrams.txt
anemia.txt	blood.txt
arabic alphabet.txt	anagrams.txt
artery.txt	blood.txt
benevento.txt	valentinian i.txt
gasoline.txt	aluminium.txt
beryl.txt	geology.txt
beryllium.txt	aluminium.txt
biome.txt	ecosystem.txt
biosphere.txt	ecosystem.txt
biotechnology.txt	chemistry.txt
blog.txt	arabic alphabet.txt
boolean algebra (structure).txt	chemistry.txt
boomerang.txt	gravity.txt
valentinian i.txt	valentinian ii.txt
valentinian ii.txt	valentinian i.txt
valentinian iii.txt	valentinian i.txt
aquarius (constellation).txt	gospel of john.txt
geology.txt	geomorphology.txt
gravity.txt	boomerang.txt
blood type.txt	blood.txt
gospel of john.txt	gospel of luke.txt
gospel of luke.txt	gospel of mark.txt
gospel of mark.txt	gospel of john.txt
jasmine.txt	eucalyptus.txt
turkey (bird).txt	cat.txt
toy story.txt	aquarius (constellation).txt
calorie.txt	cholesterol.txt
coma.txt	epilepsy.txt
cat.txt	arctic fox.txt
blood.txt	blood pressure.txt
blood pressure.txt	blood.txt
forest.txt	ecosystem.txt
arctic fox.txt	cat.txt
fruit.txt	jasmine.txt
alcohol.txt	chemistry.txt
fossil.txt	geology.txt
chemical reaction.txt	chemistry.txt
chemical element.txt	chemistry.txt
chemistry.txt	chemical element.txt
cholera.txt	allergy.txt
cholesterol.txt	calorie.txt
eucalyptus.txt	forest.txt
ecosystem.txt	biome.txt
electric motor.txt	gasoline.txt
electrolysis.txt	chemistry.txt
electron.txt	electrolysis.txt
epidemiology.txt	cholera.txt
epilepsy.txt	coma.txt