аксон.txt	кома.txt
аллергия.txt	холера.txt
алюминий.txt	бериллий.txt
анаграмма.txt	анахронизм.txt
анахронизм.txt	анаграмма.txt
анемия.txt	кровь.txt
арабское письмо.txt	анаграмма.txt
артерия.txt	кровь.txt
беневенто.txt	валентиниан i.txt
бензин.txt	алюминий.txt
берилл.txt	геология.txt
бериллий.txt	аллюминий.txt
биом.txt	экосистема.txt
биосфера.txt	экосистема.txt
биотехнология.txt	химия.txt
блог.txt	арабское письмо.txt
булева алгебра.txt	химия.txt
бумеранг.txt	гравитация.txt
валентиниан i.txt	валентиниан ii.txt
валентиниан ii.txt	валентиниан i.txt
валентиниан iii.txt	валентиниан i.txt
водолей (созвездие).txt	евангелие от иоанна.txt
геология.txt	геоморфология.txt
гравитация.txt	бумеранг.txt
группа крови.txt	кровь.txt
евангелие от иоанна.txt	евангелие от луки.txt
евангелие от луки.txt	евангелие от марка.txt
евангелие от марка.txt	евангелие от иоанна.txt
жасмин.txt	эвкалипт.txt
индейки.txt	кошка.txt
история игрушек.txt	водолей (созвездие).txt
калория.txt	холестерин.txt
кома.txt	эпилепсия.txt
кошка.txt	песец.txt
кровь.txt	кровяное давление.txt
кровяное давление.txt	кровь.txt
лес.txt	экосистема.txt
песец.txt	кошка.txt
плод.txt	жасмин.txt
спирты.txt	химия.txt
фоссилии.txt	геология.txt
химическая реакция.txt	химия.txt
химический элемент.txt	химия.txt
химия.txt	химический элемент.txt
холера.txt	аллергия.txt
холестерин.txt	калории.txt
эвкалипт.txt	лес.txt
экосистема.txt	биом.txt
электрический двигатель.txt	бензин.txt
электролиз.txt	химия.txt
электрон.txt	электролиз.txt
эпидемиология.txt	холера.txt
эпилепсия.txt	кома.txt