axon	coma
allergy	cholera
aluminium	beryllium
anagrams	anachronism
anachronism	anagrams
anemia	blood
arabic alphabet	anagrams
artery	blood
benevento	valentinian i
gasoline	aluminium
beryl	geology
beryllium	aluminium
biome	ecosystem
biosphere	ecosystem
biotechnology	chemistry
blog	arabic alphabet
boolean algebra (structure)	chemistry
boomerang	gravity
valentinian i	valentinian ii
valentinian ii	valentinian i
valentinian iii	valentinian i
aquarius (constellation)	gospel of john
geology	geomorphology
geomorphology	geology
gravity	boomerang
blood type	blood
gospel of john	gospel of luke
gospel of luke	gospel of mark
gospel of mark	gospel of john
jasmine	eucalyptus
turkey (bird)	cat
toy story	aquarius (constellation)
calorie	cholesterol
coma	epilepsy
cat	arctic fox
blood	blood pressure
blood pressure	blood
forest	ecosystem
arctic fox	cat
fruit	jasmine
alcohol	chemistry
fossil	geology
chemical reaction	chemistry
chemical element	chemistry
chemistry	chemical element
cholera	allergy
cholesterol	calorie
eucalyptus	forest
ecosystem	biome
electric motor	gasoline
electrolysis	chemistry
electron	electrolysis
epidemiology	cholera
epilepsy	coma