аксон	кома
аллергия	холера
алюминий	бериллий
анаграмма	анахронизм
анахронизм	анаграмма
анемия	кровь
арабское письмо	анаграмма
артерия	кровь
беневенто	валентиниан i
бензин	алюминий
берилл	геология
бериллий	алюминий
биом	экосистема
биосфера	экосистема
биотехнология	химия
блог	арабское письмо
булева алгебра	химия
бумеранг	гравитация
валентиниан i	валентиниан ii
валентиниан ii	валентиниан i
валентиниан iii	валентиниан i
водолей (созвездие)	евангелие от иоанна
геология	геоморфология
геоморфология	геология
гравитация	бумеранг
группа крови	кровь
евангелие от иоанна	евангелие от луки
евангелие от луки	евангелие от марка
евангелие от марка	евангелие от иоанна
жасмин	эвкалипт
индейки	кошка
история игрушек	водолей (созвездие)
калория	холестерин
кома	эпилепсия
кошка	песец
кровь	кровяное давление
кровяное давление	кровь
лес	экосистема
песец	кошка
плод	жасмин
спирты	химия
фоссилии	геология
химическая реакция	химия
химический элемент	химия
химия	химический элемент
холера	аллергия
холестерин	калории
эвкалипт	лес
экосистема	биом
электрический двигатель	бензин
электролиз	химия
электрон	электролиз
эпидемиология	холера
эпилепсия	кома